11111111111111111111111111111111111111111111111111
1C00000000000000000000000E0000000000000000000000C1
10000000000000000000000000000000000000000000000001
10000111111111100000000000000000000111111111100001
10000111111111100000000000000000000111111111100001
10000111111111100000000000000000000111111111100001
10000111111111100000000000000000000111111111100001
100000000C000000000000000000000000000000C000000001
10000000000000000000000000000000000000000000000001
10000000000000000000000000000000000000000000000001
10000000000000000000000000000000000000000000000001
10000111111111100000000000000000000111111111100001
100001C000P000100000000000000000000111111111100001
10000100000000100000000000000000000111111111100001
10000100000000100000000000000000000111111111100001
1000000000000000000000000000000000000000C000000001
10000000000000000000000000000000000000000000000001
11111111111111111111111111111111111111111111111111
