11111111111111111111111111111111
1C001E000000000000000000000000C1
10001000000000000000000000000001
10001000000000000000000000000001
10001000000000000000000000000001
10001C00000000000000000111111111
100011111111111000000001000000C1
10000000000000000000000100000001
10000000000000000000000100000001
10000000000000000000000100000001
10000000000000000000000000000001
10000000000000000000000000000001
11111111111111111111000000000001
1C000000000000000000000000000001
10000000000000000000000000000001
10000000000000000000000000000001
10000000000000000000000000000001
11111111000P000111111100000000C1
11111111111111111111111111111111
