11111111111111111111111111111111
10001000000000000000000000000001
10001000000000000000000000000001
10001000000000000000000000000001
10001000000000000000000000000001
10001000000000000000000111111111
10001111111111100000000100000001
10000000000000000000000100000001
10000000000000000000000100000001
10000000000000000000000100000001
10000000000000000000000000000001
10000000000000000000000000000001
11111111111111111111000000000001
10000000000E00000000000000000001
10000000000000000000000000000001
10000000000C00000000000000000001
10000000000000000000000000000001
11111111000P00011111110000000001
11111111111111111111111111111111
